09 06 06 06 06 06 06 06 06 07 06 06 06 06 06 06 06 06 10
05 00 00 00 00 00 00 00 00 05 00 00 00 00 00 00 00 00 05
05 00 09 10 00 09 07 10 00 05 00 09 07 10 00 09 10 00 05
05 00 11 12 00 11 08 12 00 04 00 11 08 12 00 11 12 00 05
05 00 00 00 00 00 00 00 00 00 00 00 00 00 00 00 00 00 05
05 00 01 03 00 02 00 01 06 07 06 03 00 02 00 01 03 00 05
05 00 00 00 00 05 00 00 00 05 00 00 00 05 00 00 00 00 05
11 06 06 10 00 14 06 03 00 04 00 01 06 13 00 09 06 06 12
00 00 00 05 00 05 00 00 00 00 00 00 00 05 00 05 00 00 00
06 06 06 12 00 04 00 09 03 00 01 10 00 04 00 11 06 06 06
00 00 00 00 00 00 00 05 00 00 00 05 00 00 00 00 00 00 00
06 06 06 10 00 02 00 11 06 06 06 12 00 02 00 09 06 06 06
00 00 00 05 00 05 00 00 00 00 00 00 00 05 00 05 00 00 00
09 06 06 12 00 04 00 01 06 07 06 03 00 04 00 11 06 06 10
05 00 00 00 00 00 00 00 00 05 00 00 00 00 00 00 00 00 05
05 00 01 10 00 01 06 03 00 04 00 01 06 03 00 09 03 00 05
05 00 00 05 00 00 00 00 00 00 00 00 00 00 00 05 00 00 05
14 03 00 04 00 02 00 01 06 07 06 03 00 02 00 04 00 01 13
05 00 00 00 00 05 00 00 00 05 00 00 00 05 00 00 00 00 05
05 00 01 06 06 08 06 03 00 04 00 01 06 08 06 06 03 00 05
05 00 00 00 00 00 00 00 00 00 00 00 00 00 00 00 00 00 05
11 06 06 06 06 06 06 06 06 06 06 06 06 06 06 06 06 06 12
