09 06 06 06 06 06 06 06 06 07 06 06 06 06 06 06 06 06 10
05 15 15 15 15 15 15 15 15 05 15 15 15 15 15 15 15 15 05
05 15 09 10 15 09 07 10 15 05 15 09 07 10 15 09 10 15 05
05 15 11 12 15 11 08 12 15 04 15 11 08 12 15 11 12 15 05
05 15 15 15 15 15 15 15 15 15 15 15 15 15 15 15 15 15 05
05 15 01 03 15 02 15 01 06 07 06 03 15 02 15 01 03 15 05
05 15 15 15 15 05 15 15 15 05 15 15 15 05 15 15 15 15 05
11 06 06 10 15 14 06 03 00 04 00 01 06 13 15 09 06 06 12
00 00 00 05 15 05 00 00 00 00 00 00 00 05 15 05 00 00 00
06 06 06 12 15 04 00 09 03 00 01 10 00 04 15 11 06 06 06
00 00 00 00 15 00 00 05 00 00 00 05 00 00 15 00 00 00 00
06 06 06 10 15 02 00 11 06 06 06 12 00 02 15 09 06 06 06
00 00 00 05 15 05 00 00 00 00 00 00 00 05 15 05 00 00 00
09 06 06 12 15 04 00 01 06 07 06 03 00 04 15 11 06 06 10
05 15 15 15 15 15 15 15 15 05 15 15 15 15 15 15 15 15 05
05 15 01 10 15 01 06 03 15 04 15 01 06 03 15 09 03 15 05
05 15 15 05 15 15 15 15 15 15 15 15 15 15 15 05 15 15 05
14 03 15 04 15 02 15 01 06 07 06 03 15 02 15 04 15 01 13
05 15 15 15 15 05 15 15 15 05 15 15 15 05 15 15 15 15 05
05 15 01 06 06 08 06 03 00 04 15 01 06 08 06 06 03 15 05
05 15 15 15 15 15 15 15 15 15 15 15 15 15 15 15 15 15 05
11 06 06 06 06 06 06 06 06 06 06 06 06 06 06 06 06 06 12
